9 9
0 1 1 1 1 1 0 0 0
0 1 2 2 2 1 1 1 1
0 1 2 2 2 1 2 2 1
0 1 1 2 2 2 2 2 1
1 1 1 2 1 1 1 6 1
1 2 2 2 1 0 1 6 1
1 2 2 2 1 0 1 6 1
1 2 2 2 1 0 1 1 1
1 1 1 1 1 0 0 0 0
9 10
0 0 1 1 1 1 1 1 1 0
0 0 1 2 2 2 2 2 1 0
0 0 1 2 2 2 2 2 1 0
1 1 1 1 1 2 1 2 1 0
1 2 2 2 2 2 2 2 1 0
1 2 2 1 2 1 1 2 1 1
1 6 6 2 2 2 1 2 2 1
1 6 6 2 2 2 2 2 2 1
1 1 1 1 1 1 1 1 1 1 
8 6
1 1 1 1 1 1 
1 6 6 6 6 1
1 6 2 2 2 1
1 1 2 2 2 1
1 1 2 2 1 1
1 2 2 2 1 0
1 1 2 2 1 0
0 1 1 1 1 0
8 8
1 1 1 1 1 1 1 1
1 6 2 2 2 2 2 1
1 6 2 2 2 1 2 1
1 6 1 2 1 2 2 1
1 1 1 2 1 2 1 1
0 1 2 2 2 2 1 0
0 1 2 2 1 1 1 0
0 1 1 1 1 1 0 0
7 10
0 1 1 1 1 1 1 1 1 0
1 1 6 6 1 2 2 2 1 0
1 2 6 6 1 2 2 2 1 1
1 2 2 2 2 2 2 2 2 1
1 1 2 1 1 1 2 2 2 1 
0 1 2 2 2 2 2 1 1 1
0 1 1 1 1 1 1 1 0 0